1111111111111111111111111111111111111111
1C000100001111000C0000010010000001E1C101
1000010010001000000000000010000001010101
1000011110010000000010000001000000000001
1110000010111100000010000000000001010101
1C00P000000000000C00100000100000010111C1
1111111111111111111111111111111111111111
1111110000110000001100000011000000111111
1111111100111111001111110011011100111111
1111111100111111001111110E11111100111111
1111111100110000001100000011111100111111
1111111100111111001111110011111100111111
1111111100111111001111110011111100111111
1111111100110000001100000011111100111111
1111111111111111111111111111111111111111